2222222222222222222222222
2000100101000011000000002
2022102222220011222021102
2122100020011011002021102
2111100020111020002022202
2000000020200020000000002
2222122111221220121212102
2010001020200020101010102
2011211020111020121212102
2022222020011010000000002
2021112020000010001111002
2001010011221222212222212
2122122120210120101020102
2000000020200010010020012
2222222222222222222222222